11111111111111111111111111
22222222222222222222222222
3333333333333333333333333
44444444444444444444444444
55555555555555555555555555
66666666666666666666666666
7777777777777777777777777
888888888888888888888888
